00001000000000000!
00001000000000000!
00001000000000000!
00001000000000000!
00001000000000000!
00001000000000000!
00001111011101111!
00000001010101000!
00000001110111000!
00000000000000000!