01000000000000000!
01111111111100000!
00000000000100000!
00000000000100000!
00000000000100000!
00000000000100000!
00000000000111111!
00000000000000000!
00000000000000000!
00000000000000000!