01000000000000000!
01000000000000000!
01111100000011111!
00000100000010000!
00000111111010000!
00000000001010000!
00000000001110000!
00000000000000000!
00000000000000000!
00000000000000000!

