01000000000000000!
01000000000000000!
01000001111111100!
01000001000000100!
01111111000000100!
00000000000000100!
00000001111111100!
00000001000000000!
00000001000000000!
00000001000000000!