01000000000000000!
01111111000000000!
00000001000000000!
00000001000000000!
00000001111000000!
00000000001000000!
00000001111000000!
01111111000000000!
01000000000000000!
01000000000000000!