00000000000001000!
00000000000001000!
00000000000001000!
00000000000001000!
00000000000001000!
00000000000001000!
00000000000001000!
00000000000001000!
00000000000001111!
00000000000000000!