00100000000010000!
00100000000010000!
00100000000010000!
00100000000010000!
00100000000010000!
00111111111110000!
00000000000000000!
00000000000000000!
00000000000000000!
00000000000000000!