01000000000000000!
01000000000000000!
01000000000000000!
01000000000000000!
01111111111100011!
00000000000111110!
00000000000000000!
00000000000000000!
00000000000000000!
00000000000000000!