00000000100000000!
00000000100000000!
00011111100000000!
00010000000000000!
00011111111000000!
00000000001000000!
00000000001000000!
00000000001000000!
00000000001111111!
00000000000000000!