01000000000000000!
01011111111100000!
01010000000100000!
01010000000100000!
01110000000111111!
00000000000000000!
00000000000000000!
00000000000000000!
00000000000000000!
00000000000000000!