00100000000000000!
00100000000000000!
00100000000000000!
00100000000000000!
00100000011111111!
00100000010000000!
00100111010000000!
00111101010000000!
00000001110000000!
00000000000000000!