00000010000000000!
00000010000000000!
00000010111110000!
00000010100010000!
00000010100010000!
00000011100011111!
00000000000000000!
00000000000000000!
00000000000000000!
00000000000000000!