01000000000000000!
01000000000000000!
01111111111111100!
00000000000000100!
00000111111111100!
00000100000000000!
00000111111100000!
00000000000100000!
00000000000111111!
00000000000000000!
