01000000000000000!
01000000000000000!
01000000000000000!
01000000000000000!
01000000111111000!
01000000100001000!
01111111100001000!
00000000000001111!
00000000000000000!
00000000000000000!